|||||||||||||||||||
|  a     a     a  |
| ||| | ||| | ||| |
|a| |a|     |a| |a|
| ||| | | | | ||| |
|     | | | |     |
| ||||| | | ||||| |
|a| a         a |a|
| | |||||a||||| | |
|   a   hbbbt a   |
| ||||| ||| ||||| |
|  a    | |    a  |
| ||| | ||| | ||| |
| | | |  a  | | | |
| |||a| ||| |a||| |
|     | | | |     |
| ||||| ||| ||||| |
|        a        |
|||||||||||||||||||
