|||||||||||||||||||
|  a   a   a   a  |
| ||| ||| ||| ||| |
|a|   |a|a|a|   |a|
| ||| | ||| | ||| |
|     |     |     |
| ||| ||||| ||| | |
|a| a         a |a|
| | |||||a||||| | |
|   a   hbtbb a   |
| ||||| ||| ||||| |
|  a    | |    a  |
| ||| ||| ||| ||| |
| | | |  a  | | | |
| |||a| ||| |a||| |
|     | | | |     |
| ||| | ||| | ||| |
|        a        |
|||||||||||||||||||
