|||||||||||||||||||
| a   a     a   a |
| ||| ||| ||| ||| |
|a|     |a|     |a|
| ||| ||| ||| ||| |
|     |     |     |
| ||||| ||| ||||| |
|a   a   a   a   a|
| |||||a||||| ||| |
| a a   bbtbh   a |
| ||||| ||| ||||| |
| a     | |     a |
| ||| ||| ||| ||| |
| |   |  a  |   | |
| |||a| ||| |a||| |
|     | | | |     |
| ||| | ||| | ||| |
|    a    a     a |
|||||||||||||||||||
